8 8 9 9 9 10 10 10 10 9 9 9 8 8 8 
8 8 8 9 9 9 10 10 10 10 9 9 9 8 8 
8 8 9 12 9 10 10 10 10 9 9 9 8 8 8 
8 8 8 9 9 9 10 10 10 10 9 9 9 8 8 
8 8 9 9 9 10 10 10 10 9 9 9 8 8 8 
8 8 8 9 9 9 10 10 10 10 9 9 9 8 8 
8 8 9 9 9 10 10 10 10 9 9 12 8 8 8 
8 8 8 9 9 9 10 10 10 10 9 9 9 8 8 
8 8 9 9 9 10 10 10 10 9 9 9 8 8 8 
8 8 8 9 9 9 10 10 10 10 9 9 9 8 8 
8 8 9 9 11 10 10 10 10 9 9 9 8 8 8 
8 8 8 9 9 9 10 10 10 10 9 9 9 8 8 
8 8 9 9 9 10 10 10 10 9 9 9 8 8 8 
8 8 8 9 9 9 10 10 10 10 9 11 9 8 8 
8 8 9 9 9 10 10 10 10 9 9 9 8 8 8 

80 0 0 72 0 0 0 73 0 0 0 71 0 0 67 
0 0 0 0 0 0 0 0 0 0 0 0 0 0 0 
0 0 0 0 0 0 0 83 0 0 0 0 0 0 0 
45 0 0 0 0 45 45 41 45 45 0 0 0 0 45 
69 0 0 0 0 0 0 0 0 0 0 0 0 0 69 
0 83 0 0 0 0 0 86 0 0 0 0 0 83 0 
45 45 45 0 0 0 45 45 45 0 0 0 45 45 45 
0 0 0 0 0 0 0 69 0 0 0 0 0 0 0 
9 0 0 0 0 0 0 0 0 0 0 0 0 0 0 
2 2 2 2 0 0 0 0 0 0 0 0 0 0 0 
0 70 0 70 0 0 0 0 0 0 0 0 0 0 2 
0 0 0 0 0 0 81 0 0 0 0 0 0 0 0 
2 2 2 2 2 2 2 2 2 2 2 2 0 0 2 
74 0 82 0 0 0 0 0 83 42 0 0 0 84 0 
6 7 7 7 7 8 41 6 7 7 7 8 2 43 2 
