1 1 1 1 1 1 1 1 1 1 1 1 1 1 1 
1 1 2 1 1 1 1 1 1 1 1 1 1 1 1 
1 1 3 1 2 2 2 2 2 2 2 2 1 1 1 
1 1 2 1 2 2 2 2 2 2 2 2 1 1 1 
2 1 3 1 1 1 1 1 1 1 1 1 1 1 1 
2 3 3 3 2 2 2 2 2 2 2 2 1 1 1 
1 1 3 1 1 1 1 1 1 1 1 1 1 1 1 
1 1 2 1 1 1 1 1 1 1 1 1 1 1 1 
1 1 3 1 1 1 1 1 1 1 1 1 1 1 1 
1 1 2 1 1 2 2 2 2 1 1 1 1 1 1 
1 1 6 1 1 2 2 2 2 1 1 1 1 1 1 
1 1 1 1 1 1 1 1 1 1 1 1 1 1 1 
2 2 2 2 2 2 2 2 2 2 2 2 2 2 2 
2 2 2 2 2 2 2 2 7 2 2 2 2 2 2 
1 1 1 1 1 1 1 1 1 1 1 1 1 1 1 

81 0 0 0 0 0 0 0 0 0 82 0 42 0 0 
2 2 0 2 7 7 7 7 7 7 7 7 8 0 0 
2 2 0 2 0 0 0 0 0 0 0 0 0 0 0 
2 2 0 2 0 0 83 67 0 0 0 0 0 0 0 
73 2 0 2 7 7 7 7 7 7 7 8 0 0 0 
0 0 0 0 0 0 0 0 0 0 0 0 2 0 0 
2 2 0 2 2 2 2 0 0 2 0 0 2 0 0 
2 2 0 2 0 0 0 0 0 0 0 0 2 0 0 
2 2 0 2 67 0 0 0 0 0 0 2 9 0 0 
2 2 0 2 2 0 0 0 0 2 0 0 2 0 0 
2 2 0 2 2 85 0 0 85 2 0 0 2 0 0 
2 2 0 2 2 2 2 2 2 2 0 0 2 0 0 
2 0 0 0 2 0 68 0 2 0 0 0 2 0 0 
75 0 0 0 71 0 0 70 10 0 0 0 42 0 2 
2 2 11 2 2 2 11 2 2 2 2 2 2 2 2 
