3 3 3 3 3 3 3 3 3 3 3 3 3 3 3 
2 2 2 2 2 2 2 2 2 2 2 2 2 2 2 
1 1 1 1 1 1 1 1 1 1 1 1 1 1 1 
2 2 2 2 2 2 2 2 2 2 2 2 2 2 2 
3 3 3 3 3 3 3 3 3 3 3 3 3 3 3 
2 2 2 2 2 2 2 2 2 2 2 2 2 2 2 
1 1 1 1 1 1 1 1 1 1 1 1 1 1 1 
2 2 2 2 2 2 2 2 2 2 2 2 2 2 2 
3 3 3 3 3 3 3 3 3 3 3 3 3 3 3 
2 2 2 2 2 2 2 2 2 2 2 2 2 2 2 
1 1 1 1 1 1 1 1 1 1 1 1 1 1 1 
2 2 2 2 2 2 2 2 2 2 2 2 2 2 2 
3 3 3 3 3 3 3 3 3 3 3 3 3 3 3 
2 2 2 2 2 2 2 2 2 2 2 2 2 2 2 
1 1 1 1 1 1 1 1 1 1 1 1 1 1 1 

0 0 0 0 0 0 0 0 0 0 0 0 14 0 0 
41 2 13 2 2 2 2 2 2 2 2 2 12 0 0 
0 0 15 0 0 0 0 0 0 0 0 0 0 0 0 
0 0 12 2 2 2 2 2 2 2 2 2 13 13 2 
0 0 0 0 0 0 31 2 82 0 0 0 17 16 9 
2 2 2 2 2 2 2 2 2 2 2 2 12 12 2 
0 0 0 0 0 2 1 35 1 2 0 0 0 0 0 
0 0 0 0 0 20 2 69 2 26 0 0 0 0 0 
0 11 11 11 11 11 2 69 2 11 11 11 11 11 0 
0 0 72 0 0 0 0 0 0 0 0 0 72 0 0 
0 0 0 0 0 0 0 0 0 0 0 0 0 0 0 
43 45 45 45 45 0 0 43 0 0 45 45 45 45 43 
73 0 0 71 0 0 0 0 0 0 0 71 0 0 73 
0 0 0 0 0 85 0 81 0 0 0 0 0 0 85 
41 2 2 2 2 2 43 2 43 2 2 2 2 2 3 
