2 2 2 2 2 2 2 2 2 2 2 2 2 2 2 
2 2 2 2 2 2 2 2 2 2 2 2 2 2 2 
1 1 1 1 1 1 1 1 1 1 1 1 1 1 1 
1 1 1 1 1 1 1 1 1 1 1 1 1 1 1 
2 2 2 2 2 2 2 2 2 2 2 2 2 2 2 
2 2 2 2 2 2 2 2 2 2 2 2 2 2 2 
1 1 1 1 1 1 1 1 1 1 1 1 1 1 1 
1 1 1 1 1 1 1 1 1 1 1 1 1 1 1 
2 2 2 2 2 2 2 2 2 2 2 2 2 2 2 
2 2 2 2 2 2 2 2 2 2 2 2 2 2 2 
1 1 1 1 1 1 1 1 1 1 1 1 1 1 1 
1 1 1 1 1 1 1 1 1 1 1 1 1 1 1 
2 2 2 2 2 2 2 2 2 2 2 2 2 2 2 
2 2 2 2 2 2 2 2 2 2 2 2 2 2 2 
1 1 1 1 1 1 1 1 1 1 1 1 1 1 1 

0 0 13 0 0 0 0 84 0 0 0 73 0 0 0 
9 0 17 0 0 0 1 0 1 0 0 0 0 0 82 
2 2 12 2 2 2 2 0 2 2 2 2 2 2 2 
0 0 0 78 0 73 13 0 13 2 13 2 13 2 0 
35 1 85 0 0 0 18 0 60 48 15 48 60 48 0 
6 7 7 7 7 8 12 0 12 2 12 2 12 2 38 
0 0 71 0 78 0 2 0 13 0 0 0 72 0 2 
31 1 85 0 0 0 42 0 14 0 27 0 83 0 0 
2 2 2 2 2 2 2 0 12 2 2 2 2 2 2 
0 0 0 69 0 78 2 0 2 70 0 70 0 67 0 
20 1 85 0 0 0 1 0 1 0 0 0 83 0 0 
6 7 7 7 7 7 8 0 6 7 7 7 7 7 8 
0 0 70 0 70 0 0 0 0 72 0 0 0 0 0 
81 0 0 0 0 0 0 0 0 0 0 0 0 0 0 
2 2 2 2 2 2 2 43 2 2 2 2 2 2 2 
