3 3 3 2 2 2 1 1 1 2 2 2 1 1 1 
2 2 2 1 1 1 2 2 2 3 3 3 2 2 2 
1 1 1 2 2 2 3 3 3 2 2 2 1 1 1 
2 2 2 3 3 3 2 2 2 1 1 1 2 2 2 
3 3 3 2 2 2 1 1 1 2 2 2 3 3 3 
2 2 2 1 1 1 2 2 2 3 3 3 2 2 2 
1 1 1 2 2 2 3 3 3 2 2 2 1 1 1 
2 2 2 3 3 3 2 2 2 1 1 1 2 2 2 
3 3 3 2 2 2 1 1 1 2 2 2 3 3 3 
2 2 2 1 1 1 2 2 2 3 3 3 2 2 2 
1 1 1 2 2 2 3 3 3 2 2 2 1 1 1 
2 2 2 3 3 3 2 2 2 1 1 1 2 2 2 
3 3 3 2 2 2 1 1 1 2 2 2 3 3 3 
2 2 2 1 1 1 2 2 2 3 3 3 2 2 2 
1 1 1 2 2 2 3 3 3 2 2 2 1 1 1 

0 0 0 0 0 0 0 3 0 13 0 0 0 0 0 
21 0 0 81 0 0 32 5 29 14 0 83 2 13 0 
2 13 11 41 11 13 2 4 2 12 2 2 0 18 0 
0 14 0 87 0 17 0 5 0 0 0 0 0 18 0 
0 12 2 2 2 12 0 5 0 0 0 0 2 12 0 
0 0 0 0 0 0 0 4 0 0 0 2 0 13 0 
0 0 0 2 1 2 2 4 2 0 2 0 0 15 0 
0 0 0 2 0 0 82 4 9 0 2 2 2 15 0 
0 0 0 2 43 2 2 2 2 2 13 0 0 12 0 
0 86 0 0 0 0 13 0 13 0 17 0 0 0 0 
6 7 8 0 0 0 60 0 14 0 15 0 2 2 43 
72 73 2 2 2 2 15 0 61 2 12 43 2 73 72 
0 0 0 2 2 1 12 43 12 1 2 2 0 0 0 
84 0 10 10 10 1 2 2 2 1 10 10 10 0 84 
41 10 10 1 1 1 1 1 1 1 1 1 10 10 41 
