2 2 3 3 2 2 1 1 2 2 3 3 2 2 1 
2 2 3 3 2 2 1 1 2 2 3 3 2 2 1 
1 2 2 3 3 2 2 1 1 2 2 3 3 2 2 
1 2 2 3 3 2 2 1 1 2 2 3 3 2 2 
1 1 2 2 3 3 2 2 1 1 2 2 3 3 2 
1 1 2 2 3 3 2 2 1 1 2 2 3 3 2 
2 1 1 2 2 3 3 2 2 1 1 2 2 3 3 
2 1 1 2 2 3 3 2 2 1 1 2 2 3 3 
2 2 1 1 2 2 3 3 2 2 1 1 2 2 3 
2 2 1 1 2 2 3 3 2 2 1 1 2 2 3 
3 2 2 1 1 2 2 3 3 2 2 1 1 2 2 
3 2 2 1 1 2 2 3 3 2 2 1 1 2 2 
3 3 2 2 1 1 2 2 3 3 2 2 1 1 2 
3 3 2 2 1 1 2 2 3 3 2 2 1 1 2 
2 3 3 2 2 1 1 2 2 3 3 2 2 1 1 

0 0 0 2 13 72 2 2 69 2 69 2 0 0 84 
0 0 0 1 16 0 28 40 0 48 0 42 66 0 0 
41 6 7 7 12 2 2 2 2 2 2 2 65 2 2 
72 0 0 1 0 0 0 13 0 0 0 2 66 0 0 
33 0 0 2 0 0 0 14 0 0 0 2 65 0 0 
6 7 7 7 7 8 41 12 2 2 79 1 2 2 41 
71 0 0 13 0 0 0 13 0 73 2 0 0 0 0 
0 0 0 61 0 0 65 18 0 0 2 2 13 13 0 
2 0 0 12 2 2 65 12 0 0 2 0 16 15 0 
0 0 0 2 70 0 66 2 0 0 2 0 12 12 2 
66 0 0 2 0 0 65 2 0 67 2 79 0 48 66 
65 2 2 2 41 6 7 7 7 7 7 7 7 8 66 
66 0 0 0 0 0 2 2 2 13 69 0 0 0 65 
66 81 0 0 0 0 22 9 1 19 0 0 82 0 66 
2 2 2 2 2 2 2 2 2 12 2 2 2 2 2 
