2 2 2 2 2 2 2 2 2 2 2 2 2 2 2 
2 2 2 2 2 2 2 2 2 2 2 2 2 2 2 
2 2 1 1 1 1 1 1 1 1 1 1 1 2 2 
2 2 1 1 1 1 1 1 1 1 1 1 1 2 2 
2 2 1 1 2 2 2 2 2 2 2 1 1 2 2 
2 2 1 1 2 2 2 2 2 2 2 1 1 2 2 
2 2 1 1 2 2 3 3 3 2 2 1 1 2 2 
2 2 1 1 2 2 3 3 3 2 2 1 1 2 2 
2 2 1 1 2 2 3 3 3 2 2 1 1 2 2 
2 2 1 1 2 2 2 2 2 2 2 1 1 2 2 
2 2 1 1 2 2 2 2 2 2 2 1 1 2 2 
2 2 1 1 1 1 1 1 1 1 1 1 1 2 2 
2 2 1 1 1 1 1 1 1 1 1 1 1 2 2 
2 2 2 2 2 2 2 2 2 2 2 2 2 2 2 
2 2 2 2 2 2 2 2 2 2 2 2 2 2 2 

0 0 13 0 0 0 2 71 0 2 0 73 0 13 0 
66 0 14 0 0 65 2 0 0 2 0 0 0 16 67 
65 2 12 2 3 65 2 0 0 2 0 0 2 12 2 
66 0 0 0 4 66 0 0 0 2 0 0 6 7 8 
66 0 81 66 5 65 2 0 0 2 0 0 0 0 0 
6 7 8 65 4 72 2 0 0 13 2 2 13 0 0 
69 0 0 66 5 11 2 0 0 59 0 0 61 0 0 
0 0 2 2 4 2 2 11 2 12 2 2 12 2 2 
0 0 0 0 0 0 0 42 9 2 0 0 0 0 0 
0 0 10 0 0 10 0 2 2 2 0 10 0 10 0 
21 0 41 28 1 1 1 2 2 2 31 35 41 1 1 
6 7 7 8 0 0 0 0 0 70 6 7 8 0 0 
0 0 0 0 0 0 0 0 0 0 0 0 0 0 0 
86 0 0 0 0 0 10 0 0 0 0 0 0 0 82 
2 2 2 2 2 43 2 2 2 2 2 2 2 2 2 
