3 3 3 3 3 3 3 3 3 3 3 3 3 3 3 
3 3 3 3 3 3 3 3 3 3 3 3 3 3 3 
3 3 3 3 3 3 3 3 3 3 3 3 3 3 3 
3 3 3 3 3 3 3 3 3 3 3 3 3 3 3 
3 3 3 3 3 3 3 3 3 3 3 3 3 3 3 
2 2 2 2 2 2 2 2 2 2 2 2 2 2 2 
2 2 2 2 2 2 2 2 2 2 2 2 2 2 2 
2 2 2 2 2 2 2 2 2 2 2 2 2 2 2 
2 2 2 2 2 2 2 2 2 2 2 2 2 2 2 
2 2 2 2 2 2 2 2 2 2 2 2 2 2 2 
1 1 1 1 1 1 1 1 1 1 1 1 1 1 1 
1 1 1 1 1 1 1 1 1 1 1 1 1 1 1 
1 1 1 1 1 1 1 1 1 1 1 1 1 1 1 
1 1 1 1 1 1 1 1 1 1 1 1 1 1 1 
1 1 1 1 1 1 1 1 1 1 1 1 1 1 1 

0 82 0 1 0 0 42 15 64 14 64 0 0 0 35 
2 2 2 2 2 41 2 2 2 2 2 45 45 45 2 
72 0 72 0 0 0 0 0 73 0 0 0 0 0 0 
0 0 0 0 81 0 0 0 0 0 0 0 0 0 67 
0 0 0 2 2 2 2 0 0 0 0 0 0 0 0 
0 0 0 0 42 0 0 2 0 0 0 0 2 11 2 
6 7 7 7 8 0 0 2 43 0 43 11 2 2 2 
0 71 0 71 0 0 0 0 2 11 2 2 0 17 0 
0 0 0 0 0 0 0 0 0 0 0 0 0 17 9 
0 10 0 10 0 10 0 10 0 10 0 10 0 2 2 
20 26 35 41 6 7 7 7 7 7 8 43 2 2 2 
0 0 0 0 64 0 64 67 64 0 64 0 78 0 0 
0 0 2 11 2 11 2 11 2 11 2 11 2 0 0 
0 2 69 2 69 1 69 1 69 1 69 2 69 2 0 
41 0 1 70 1 70 1 70 1 70 1 70 1 0 41 
