8 8 9 9 10 10 9 9 8 8 9 9 10 10 9 
8 8 9 9 10 10 9 9 8 8 9 9 10 10 9 
8 8 9 9 10 10 9 9 8 8 9 9 10 10 9 
8 8 9 9 10 10 9 9 8 8 9 9 10 10 9 
8 8 9 9 10 10 9 9 8 8 9 9 10 10 9 
8 8 9 9 10 10 9 9 8 8 9 9 10 10 9 
8 8 9 12 10 10 9 9 8 8 9 11 10 10 9 
8 8 9 9 10 10 9 9 8 8 9 9 10 10 9 
8 8 9 9 10 10 9 9 8 8 9 9 10 10 9 
8 8 9 9 10 10 9 9 8 8 9 9 10 10 9 
8 8 9 9 10 10 9 9 8 8 9 9 10 10 9 
8 8 11 9 10 10 9 9 8 8 9 9 10 10 9 
8 8 9 9 10 10 9 9 8 8 9 9 10 10 9 
8 8 9 9 10 10 9 9 8 12 9 9 10 10 9 
8 8 9 9 10 10 9 9 8 8 9 9 10 10 9 

2 71 0 0 0 48 0 81 0 48 0 0 0 71 2 
73 2 2 0 0 2 2 2 2 2 0 0 2 2 73 
0 0 42 0 0 0 83 67 83 0 0 0 42 0 0 
0 0 2 2 2 2 2 2 2 2 2 2 2 0 0 
0 0 0 10 0 10 79 65 79 10 0 10 0 0 0 
0 6 7 7 2 1 2 66 2 1 2 7 7 8 0 
0 0 64 0 48 0 0 65 0 0 48 0 64 0 0 
2 2 2 45 6 7 7 7 7 7 8 45 2 2 2 
0 0 0 0 0 0 0 0 0 0 0 0 0 0 0 
7 8 0 0 0 0 0 9 0 0 0 0 0 6 7 
0 0 0 6 8 0 0 2 0 0 6 8 0 0 0 
2 2 0 0 0 0 0 0 0 0 0 0 0 2 2 
68 0 0 2 2 2 2 2 2 2 2 2 0 0 68 
7 8 0 0 0 0 0 82 0 0 0 0 0 6 7 
0 1 43 1 1 1 1 2 1 1 1 1 43 1 0 
