1 1 1 2 2 3 3 3 3 3 2 7 1 1 1 
1 1 1 1 1 1 1 1 1 1 1 1 1 1 1 
1 1 1 1 1 1 1 1 1 1 1 1 1 1 1 
1 1 1 1 1 1 1 1 1 1 1 1 1 1 1 
1 1 1 1 1 1 1 1 1 2 2 2 2 1 1 
1 1 1 1 1 1 1 1 1 2 1 1 2 1 1 
1 1 1 1 1 1 1 1 1 2 3 3 2 1 1 
1 1 1 1 1 1 1 1 1 2 2 2 2 1 1 
1 1 1 1 1 1 1 1 1 1 1 1 1 1 1 
1 1 1 1 1 1 1 1 1 1 1 1 1 1 1 
1 1 1 1 1 1 1 1 1 1 1 1 1 1 1 
2 2 2 2 2 2 2 2 2 2 2 2 2 2 2 
2 2 2 2 2 2 2 2 2 2 2 2 2 2 2 
2 2 2 2 2 2 2 2 2 2 2 2 6 2 2 
1 1 1 1 1 1 1 1 1 1 1 1 1 1 1 

32 0 0 0 0 0 0 83 0 0 0 0 0 0 35 
1 1 1 6 7 8 1 1 1 6 7 8 1 1 1 
0 13 0 0 0 0 0 0 0 69 0 0 69 0 0 
0 14 0 82 0 0 2 0 0 0 0 0 0 0 0 
0 12 2 2 13 2 2 0 0 0 81 0 0 0 67 
0 0 0 0 15 0 2 0 0 0 6 8 0 0 0 
2 13 2 2 12 0 2 26 0 0 0 0 0 0 20 
0 58 0 0 0 0 2 73 0 0 0 0 0 0 72 
0 12 2 2 13 2 2 0 0 0 0 0 0 0 0 
0 0 0 0 59 0 2 65 0 0 0 0 0 0 0 
2 13 2 2 12 0 2 66 2 0 1 0 1 0 0 
0 14 0 0 0 0 2 65 65 11 11 11 11 11 11 
71 12 2 13 2 2 2 13 66 2 2 2 2 2 2 
0 0 0 17 0 0 0 16 66 0 0 42 0 0 9 
2 2 2 12 2 2 2 12 2 2 2 2 2 2 2 
