3 3 1 1 1 1 1 1 1 1 1 1 1 3 3 
1 1 3 1 1 1 1 1 1 1 1 1 3 1 1 
1 1 1 7 1 1 1 1 1 1 1 1 1 1 1 
2 2 2 2 2 2 2 2 2 2 2 2 6 2 2 
2 2 2 2 2 2 2 2 2 2 2 2 2 2 2 
1 1 1 1 1 1 1 1 1 1 1 1 1 1 1 
3 3 3 2 2 2 2 2 2 2 2 2 2 2 2 
1 1 1 1 1 1 1 1 1 1 3 1 1 1 1 
2 2 2 2 3 3 2 2 2 2 4 2 2 2 2 
1 1 1 1 1 1 1 1 3 1 1 1 3 1 1 
2 2 2 2 2 2 2 2 2 2 2 2 2 2 2 
2 4 2 2 2 2 2 2 2 2 2 2 2 2 2 
1 1 1 1 3 3 1 1 2 2 1 1 2 2 1 
1 1 1 1 1 1 1 1 2 2 1 1 2 2 1 
1 1 1 1 1 1 1 1 1 1 1 1 1 1 1 

72 0 0 42 0 0 0 82 0 0 0 42 0 0 72 
0 0 0 6 7 7 7 7 7 7 7 8 0 0 0 
0 0 0 0 0 0 0 0 0 0 0 0 0 0 0 
0 0 0 0 0 0 0 9 0 0 0 0 0 0 0 
6 7 8 0 0 0 6 7 8 0 0 0 6 7 8 
70 0 0 0 0 0 0 0 0 0 0 0 0 0 71 
0 0 0 0 6 7 2 0 85 0 0 0 85 0 0 
83 0 0 0 0 0 2 0 2 0 0 0 2 0 0 
6 7 8 0 0 0 2 0 0 0 0 0 0 0 0 
69 0 0 0 0 0 2 0 0 0 2 0 0 0 2 
0 0 0 0 6 7 2 0 0 0 67 0 0 0 0 
83 0 0 0 0 0 2 2 2 2 2 2 2 2 2 
6 7 8 0 0 0 0 0 0 0 0 0 0 69 0 
0 0 0 0 0 0 0 81 0 0 0 0 0 0 0 
2 2 2 2 2 2 2 2 2 2 2 2 2 2 2 
