1 1 1 1 1 1 1 1 1 1 1 1 1 1 1 
2 2 2 2 2 2 2 3 2 2 2 2 2 2 2 
2 2 2 2 2 2 2 3 2 2 2 2 2 2 2 
1 1 1 1 1 1 1 1 1 1 1 1 1 1 1 
1 1 1 1 1 1 1 1 1 1 1 1 1 1 1 
2 2 2 2 2 2 2 3 2 2 2 2 2 2 2 
2 2 2 2 2 2 2 3 2 2 2 2 2 2 2 
1 1 1 1 1 1 1 1 1 1 1 1 1 1 1 
1 1 1 1 1 1 1 1 1 1 1 1 1 1 1 
2 2 2 2 2 2 2 3 2 2 2 2 2 2 2 
2 2 2 2 2 2 2 3 2 2 2 2 2 2 2 
1 1 1 1 1 1 1 1 1 1 1 1 1 1 1 
1 1 1 1 1 1 1 1 1 1 1 1 1 1 1 
2 2 2 2 2 2 2 3 2 2 2 2 2 2 2 
2 2 2 2 2 2 2 3 2 2 2 2 2 2 2 

2 2 13 2 2 13 2 2 2 2 2 2 2 2 2 
2 66 15 0 0 58 0 65 0 0 48 0 0 22 2 
2 65 12 2 2 12 2 66 2 45 2 45 2 2 2 
2 66 0 0 73 78 2 66 0 0 64 0 0 68 2 
2 66 0 0 0 40 2 65 2 11 2 11 2 2 2 
2 2 2 2 2 2 2 66 2 2 2 2 2 2 2 
2 0 13 0 0 0 2 65 2 0 0 13 72 0 2 
2 38 19 0 0 83 2 65 2 41 0 60 0 66 2 
2 2 12 2 2 2 2 66 2 2 20 12 2 65 2 
2 0 0 71 0 0 2 66 0 69 2 0 0 66 2 
2 21 0 0 0 41 2 65 0 0 42 0 0 65 2 
2 2 2 2 2 2 2 65 2 2 2 2 2 2 2 
2 0 13 0 70 0 0 66 2 0 0 0 13 0 2 
2 67 16 0 0 0 81 65 2 82 0 0 18 9 2 
2 2 12 2 2 2 2 2 2 2 2 2 12 2 2 
