1 1 1 1 1 1 1 1 1 1 1 1 1 1 1 
1 1 1 1 1 1 1 1 1 1 1 1 1 1 1 
2 2 2 1 1 1 1 1 1 1 1 1 2 2 2 
2 2 2 1 1 1 1 1 1 1 1 1 2 2 2 
1 1 1 1 1 1 5 1 1 1 1 1 1 1 1 
1 1 1 1 1 1 1 1 1 1 1 1 1 1 1 
1 1 1 1 1 1 1 1 1 1 1 1 1 1 1 
1 1 1 1 1 1 1 1 1 1 1 1 1 1 1 
3 2 1 1 1 1 1 1 1 1 1 1 1 1 1 
3 2 1 1 1 1 1 1 1 1 1 1 1 1 1 
3 2 1 1 1 1 1 1 1 1 1 1 1 1 1 
1 1 1 1 1 1 1 1 1 1 1 1 1 1 1 
1 1 1 1 1 1 1 1 1 1 1 1 1 1 1 
1 1 1 1 1 4 2 2 2 2 2 2 2 2 1 
1 1 1 1 1 2 2 2 2 2 2 2 2 2 1 

20 0 0 0 0 0 0 0 0 0 0 0 0 0 27 
6 7 7 8 45 45 45 41 45 45 45 6 7 7 8 
0 0 71 2 11 11 11 1 11 11 11 2 0 73 0 
0 0 0 2 13 13 2 2 2 2 2 2 0 0 0 
66 0 0 0 17 16 0 40 2 13 0 0 0 0 0 
65 13 2 2 12 12 2 13 0 63 0 0 2 2 2 
65 58 0 2 0 0 0 18 0 2 9 1 0 0 82 
2 12 41 2 41 2 2 12 2 2 2 2 2 2 2 
72 0 0 0 0 83 0 0 0 0 0 83 0 0 0 
0 0 2 2 2 2 2 2 2 41 2 2 2 2 2 
81 0 0 0 0 0 59 14 0 0 67 0 0 0 32 
2 2 13 2 2 2 12 12 2 2 2 2 2 2 2 
0 0 15 42 0 0 0 0 0 13 0 0 0 0 69 
0 0 12 2 2 0 0 0 0 60 0 0 0 0 39 
41 2 2 1 2 2 2 2 2 12 2 2 2 2 2 
