1 1 1 3 3 3 1 1 1 3 3 3 6 1 1 
2 2 2 2 2 2 1 1 1 2 2 2 2 2 2 
1 2 1 2 2 2 2 2 2 2 2 2 1 2 1 
1 2 1 3 3 3 2 2 2 3 3 3 1 2 1 
1 2 1 2 2 2 2 2 2 2 2 2 1 2 1 
2 4 2 2 2 2 2 2 2 2 2 2 2 2 2 
1 1 1 3 3 3 1 1 1 3 3 3 1 1 1 
1 1 1 2 2 2 1 1 1 2 2 2 1 1 1 
1 1 1 2 2 2 1 1 1 2 2 2 1 1 1 
1 1 1 2 2 2 2 2 2 2 2 2 1 1 1 
1 1 1 2 2 2 2 2 2 2 2 2 1 1 1 
2 2 2 7 3 3 2 2 2 3 3 5 2 2 2 
1 2 1 2 2 2 2 2 2 2 2 2 1 2 1 
1 2 1 2 2 2 1 1 1 2 2 2 1 2 1 
1 2 1 2 2 2 1 1 1 2 2 2 1 2 1 

0 0 0 0 0 0 0 0 0 0 0 0 1 0 82 
0 0 0 0 0 0 0 0 0 0 0 0 2 2 2 
0 0 0 0 0 0 0 0 0 2 2 2 0 0 0 
0 0 0 0 9 0 2 2 2 0 0 0 72 0 73 
0 0 0 2 2 2 0 0 0 0 0 0 0 0 0 
0 0 0 0 71 0 0 0 0 0 0 0 0 0 0 
0 0 0 0 0 0 0 0 0 0 0 0 0 0 0 
0 83 0 0 0 0 0 0 0 0 0 0 0 83 0 
0 6 7 7 7 8 0 0 0 6 7 7 7 8 0 
0 0 0 0 0 0 0 0 0 0 0 0 0 0 0 
0 69 0 69 0 0 0 0 0 0 0 70 0 70 0 
0 0 0 0 0 0 6 7 8 0 0 0 0 0 0 
0 0 0 0 0 0 0 0 0 0 0 0 0 0 0 
0 0 0 0 0 0 0 81 0 0 0 0 0 0 0 
2 2 2 2 2 2 2 2 2 2 2 2 2 2 2 
